1111111
1P00001
1C00C01
1E0C001
1111111